@_K399

profondeur de champ
mélységélesség

résoudre qqchose (un problème)
megold vmit

afficher qqchose, projeter son image
kijelez vmit

megcsal vkit : tromper qqun (dans une relation de couple)
becsap vmit : tromper qqchose, en abuser.
csicseriborsó : pois chiche
beáztat vmit : faire tremper qqchose
szezám : sésame
hízik : grossir, prendre du poids
hízlal : faire grossir, faire engraisser
Vkinek aztán {igék}hetek! : J'ai beau {verbe} ça n'a aucun effet!
	J'ai beau te parler, de toutes façons tu n'écoutes pas!
	Neked aztán beszélhetek!
fedezék : abri
szolid : modeste
rendszerető : qui aime l'ordre
löncs : déjeuner du midi
némi : quelques
vmi vmivel egybekötött : quelque chose se passe en même temps que qqchose
	une conversation ayant lieu au cours du repas
	vacsorával egybekötött beszlgetés
boka : cheville (partie du corps)
tájék : alentours
meg van : j'ai trouvé (tournure impersonnelle)
	Au bout de deux jours je lui avais trouvé un nom.
	Két nap múlva már megvolt a neve.
megijed : prendre peur, s'effrayer
félsz : peur (n)
szerény : modeste
elszunyókál : s'endormir un petit peu
tisztesség : honneur
tisztességesen : normalement, dans l'ordre, comme il faut
szövet : tissu